6,10,14,10,10,10,12,2,10,12
5,2,13,4,6,12,3,10,8,5
7,12,1,5,3,11,14,14,10,13
7,15,14,11,10,8,7,9,4,1
7,11,9,6,10,12,5,6,15,12
5,2,10,11,12,7,9,5,1,5
7,10,14,12,5,5,6,9,6,13
5,4,7,11,9,5,5,6,9,5
1,5,5,2,10,9,5,1,4,5
2,11,11,10,10,10,11,10,11,9
