6,10,8,6,10,14,10,14,10,12
5,6,10,9,6,9,4,5,2,9
5,1,4,2,13,6,9,7,10,12
7,8,7,8,1,7,10,9,4,5
7,10,11,14,10,13,2,14,9,5
5,6,8,5,4,7,12,3,12,5
7,13,2,15,11,9,3,8,5,5
5,3,12,5,6,10,10,10,13,5
7,8,1,1,5,2,10,10,13,5
3,10,10,10,11,10,10,8,1,1
