4,6,10,10,14,14,10,10,14,8
5,3,10,12,7,9,6,8,5,4
7,10,8,5,5,6,11,14,9,5
5,2,10,9,5,1,4,1,6,13
3,14,14,10,11,10,11,10,13,5
4,3,13,2,10,10,10,12,5,5
3,12,7,10,14,10,10,9,1,5
6,9,5,6,13,6,10,12,4,5
5,2,9,5,1,5,2,9,5,5
3,10,10,11,10,11,10,10,11,9
